1111111111111111111111111111
1pccccccccccc11cccccccccccc1
1c1111c11111c11c11111c1111c1
1c1111c11111c11c11111c1111c1
1c1111c11111c11c11111c1111c1
1cccccccccccccccccccccccccc1
1c1111c11c11111111c11c1111c1
1c1111c11c11111111c11c1111c1
1cccccc11cccc11cccc11cccccc1
111111c11111c11c11111c111111
111111c11111c11c11111c111111
111111c11cccccccccc11c111111
111111c11c111bb111c11c111111
111111c11c15000041c11c111111
111111cccc10000001cccc111111
111111c11c12000031c11c111111
111111c11c11111111c11c111111
111111c11cccccccccc11c111111
111111c11c11111111c11c111111
111111c11c11111111c11c111111
1cccccccccccc11cccccccccccc1
1c1111c11111c11c11111c1111c1
1c1111c11111c11c11111c1111c1
1ccc11cccccccccccccccc11ccc1
111c11c11c11111111c11c11c111
111c11c11c11111111c11c11c111
1cccccc11cccc11cccc11cccccc1
1c1111111111c11c1111111111c1
1c1111111111c11c1111111111c1
1cccccccccccccccccccccccccc1
1111111111111111111111111111